ahms_lepidad_top	ahms.lepidad.top
ashl_captior_top	ashl.captior.top
athe_vicith_top	athe.vicith.top
avsq_whoency_top	avsq.whoency.top
axcs_opiuous_top	axcs.opiuous.top
bvsw_vicith_top	bvsw.vicith.top
bwkv_whoency_top	bwkv.whoency.top
bwzn_jurtion_top	bwzn.jurtion.top
cdgp_captior_top	cdgp.captior.top
cfnl_tepetic_top	cfnl.tepetic.top
dbhf_vicith_top	dbhf.vicith.top
dsgp_tepetic_top	dsgp.tepetic.top
dsqr_whoency_top	dsqr.whoency.top
dtpy_jurtion_top	dtpy.jurtion.top
elgf_whoency_top	elgf.whoency.top
fmkq_nodion_top	fmkq.nodion.top
fudo_lepidad_top	fudo.lepidad.top
fzyc_opiuous_top	fzyc.opiuous.top
gawj_landize_top	gawj.landize.top
gbwp_lepidad_top	gbwp.lepidad.top
gqzs_lepidad_top	gqzs.lepidad.top
hbau_prinify_top	hbau.prinify.top
hmwe_captior_top	hmwe.captior.top
hnqg_prinify_top	hnqg.prinify.top
husw_captior_top	husw.captior.top
iwqj_vicith_top	iwqj.vicith.top
jmai_nodion_top	jmai.nodion.top
jvxt_jurtion_top	jvxt.jurtion.top
jzqu_nodion_top	jzqu.nodion.top
kadw_whoency_top	kadw.whoency.top
kaib_nodion_top	kaib.nodion.top
kaxm_prinify_top	kaxm.prinify.top
kchz_jurtion_top	kchz.jurtion.top
kgpc_captior_top	kgpc.captior.top
ljom_prinify_top	ljom.prinify.top
ljvq_landize_top	ljvq.landize.top
lquw_whoency_top	lquw.whoency.top
lvcj_lepidad_top	lvcj.lepidad.top
lvud_nodion_top	lvud.nodion.top
mbhc_whoency_top	mbhc.whoency.top
mpvf_nodion_top	mpvf.nodion.top
muav_prinify_top	muav.prinify.top
mxso_tepetic_top	mxso.tepetic.top
mzgp_prinify_top	mzgp.prinify.top
nmdo_jurtion_top	nmdo.jurtion.top
nzmg_captior_top	nzmg.captior.top
nzqk_opiuous_top	nzqk.opiuous.top
oglk_captior_top	oglk.captior.top
ovds_lepidad_top	ovds.lepidad.top
ozxq_tepetic_top	ozxq.tepetic.top
pblw_nodion_top	pblw.nodion.top
pcem_prinify_top	pcem.prinify.top
qdvo_opiuous_top	qdvo.opiuous.top
quia_jurtion_top	quia.jurtion.top
quyb_landize_top	quyb.landize.top
qzhi_vicith_top	qzhi.vicith.top
rnyv_landize_top	rnyv.landize.top
rvax_opiuous_top	rvax.opiuous.top
rxjg_jurtion_top	rxjg.jurtion.top
rycj_tepetic_top	rycj.tepetic.top
sczx_jurtion_top	sczx.jurtion.top
smhf_opiuous_top	smhf.opiuous.top
smhu_whoency_top	smhu.whoency.top
sytx_captior_top	sytx.captior.top
tbkv_opiuous_top	tbkv.opiuous.top
tcoy_vicith_top	tcoy.vicith.top
tjbm_opiuous_top	tjbm.opiuous.top
tjpw_tepetic_top	tjpw.tepetic.top
tkwz_vicith_top	tkwz.vicith.top
tnwy_vicith_top	tnwy.vicith.top
twrm_landize_top	twrm.landize.top
ujvy_vicith_top	ujvy.vicith.top
ukfy_tepetic_top	ukfy.tepetic.top
ukjb_lepidad_top	ukjb.lepidad.top
unhz_prinify_top	unhz.prinify.top
utlq_landize_top	utlq.landize.top
utre_prinify_top	utre.prinify.top
uyvj_lepidad_top	uyvj.lepidad.top
uzms_tepetic_top	uzms.tepetic.top
vadj_tepetic_top	vadj.tepetic.top
vgqb_nodion_top	vgqb.nodion.top
vkwz_lepidad_top	vkwz.lepidad.top
vorl_whoency_top	vorl.whoency.top
vziu_lepidad_top	vziu.lepidad.top
wacf_landize_top	wacf.landize.top
wcyf_jurtion_top	wcyf.jurtion.top
wgnt_tepetic_top	wgnt.tepetic.top
whba_opiuous_top	whba.opiuous.top
wqjd_nodion_top	wqjd.nodion.top
xfzb_whoency_top	xfzb.whoency.top
ycgl_vicith_top	ycgl.vicith.top
yhsc_jurtion_top	yhsc.jurtion.top
ypoc_opiuous_top	ypoc.opiuous.top
yqkz_captior_top	yqkz.captior.top
yrxl_landize_top	yrxl.landize.top
ytzg_nodion_top	ytzg.nodion.top
zhxv_prinify_top	zhxv.prinify.top
zmoa_captior_top	zmoa.captior.top
ztpa_landize_top	ztpa.landize.top
zvlp_landize_top	zvlp.landize.top