yezl=>jzqu.nodion.top
gbid=>yhsc.jurtion.top
kikb=>zmoa.captior.top
tsts=>whba.opiuous.top
palx=>twrm.landize.top
udcq=>zhxv.prinify.top
ncfn=>cdgp.captior.top
phzf=>sytx.captior.top
etsa=>smhu.whoency.top
dehb=>bvsw.vicith.top
wnyq=>rnyv.landize.top
hqst=>utlq.landize.top
effx=>yrxl.landize.top
bkqx=>kaib.nodion.top
tbiq=>tcoy.vicith.top
rznz=>quyb.landize.top
vuyy=>jvxt.jurtion.top
iehe=>bwzn.jurtion.top
vslp=>avsq.whoency.top
qscl=>ukjb.lepidad.top
oczr=>gqzs.lepidad.top
wcmx=>vkwz.lepidad.top
ylai=>athe.vicith.top
fcgr=>axcs.opiuous.top
nadl=>hbau.prinify.top
ekzy=>mzgp.prinify.top
rklq=>vgqb.nodion.top
krfb=>vadj.tepetic.top
eagd=>ukfy.tepetic.top
ozzr=>ytzg.nodion.top
hueg=>husw.captior.top
cowy=>ljvq.landize.top
ftpt=>pblw.nodion.top
iazw=>cfnl.tepetic.top
kdbd=>qzhi.vicith.top
sitz=>zvlp.landize.top
zxma=>rxjg.jurtion.top
kwgz=>dsgp.tepetic.top
vqsp=>qdvo.opiuous.top
acfa=>quia.jurtion.top
xcqp=>smhf.opiuous.top
hetz=>tjbm.opiuous.top
mtkd=>ycgl.vicith.top
iiah=>mxso.tepetic.top
nqrt=>wqjd.nodion.top
zrhq=>kaxm.prinify.top
cxqr=>fudo.lepidad.top
gmxa=>uzms.tepetic.top
foir=>tnwy.vicith.top
pter=>hnqg.prinify.top
dvul=>tjpw.tepetic.top
wwfv=>unhz.prinify.top
przk=>lquw.whoency.top
urce=>sczx.jurtion.top
tzvo=>ozxq.tepetic.top
lrvn=>oglk.captior.top
szqd=>nzmg.captior.top
cgkb=>ypoc.opiuous.top
scbr=>rycj.tepetic.top
ncix=>kadw.whoency.top
tzmu=>muav.prinify.top
gzcz=>vorl.whoency.top
prqx=>gawj.landize.top
usle=>kchz.jurtion.top
otxi=>wgnt.tepetic.top
oxxe=>xfzb.whoency.top
wurf=>bwkv.whoency.top
emoq=>wcyf.jurtion.top
ifnh=>dtpy.jurtion.top
upvy=>dsqr.whoency.top
tikq=>mpvf.nodion.top
gxfw=>uyvj.lepidad.top
qfev=>gbwp.lepidad.top
qqta=>jmai.nodion.top
raqq=>utre.prinify.top
kgam=>fzyc.opiuous.top
fwhb=>yqkz.captior.top
wtxe=>ahms.lepidad.top
txcs=>ljom.prinify.top
xmbi=>elgf.whoency.top
dlkl=>wacf.landize.top
ztbg=>lvud.nodion.top
zlru=>ztpa.landize.top
lszr=>vziu.lepidad.top
luvi=>lvcj.lepidad.top
qzhd=>iwqj.vicith.top
hyyq=>nzqk.opiuous.top
rlat=>ovds.lepidad.top
lcrd=>rvax.opiuous.top
opre=>fmkq.nodion.top
vqwn=>pcem.prinify.top
sctt=>ujvy.vicith.top
iwiv=>tkwz.vicith.top
xdov=>dbhf.vicith.top
huhx=>nmdo.jurtion.top
wggw=>kgpc.captior.top
rlyk=>mbhc.whoency.top
kokr=>ashl.captior.top
epou=>hmwe.captior.top